111111111
1P00000C1
101111101
1C0000E01
111111111